ما هو مرض السكري؟- الأعراض والأسباب والعلاجات
تفاصيل إصابة الإنسان بمرض السكري: الأنواع والأفراد المعرضين له
الأعراض الرئيسية المصاحبة لمرض السكري وطرق كشفها
الإصابة بمرض السكري: العوامل المؤثرة وكيفية الوقاية منه
السكري من النوع الثاني: الأسباب والأعراض وطرق العلاج
السكري المرتبط بالحمل: الأسباب والعلاج وما يجب معرفته
السكري الناتج عن التلف البنكرياسي وكيفية معالجته
أنواع المرض النادرة: السكري النيوناتال والسكري الهش
التدابير والخطوات الواجب اتخاذها من أجل التعامل مع حالات السكري
المرض السكري والأحوال الصحية المصاحبة له وكيفية تجنبها
مرض السكري: الأعراض والأسباب والعلاج والأنواع
ما هو مرض السكري؟ يشرحه خبير من مركز مايو الطبي
تصنيفات مختلفة لمرض السكري: الأنواع والأسباب
علاج مرض السكري: كيفية إدارة المرض والوقاية من التعقيدات
السكري النوع الأول: المرض المزمن الذي يؤثر على خلايا البنكرياس المنتجة للأنسولين
السكري النوع الثاني: الأكثر شيوعا والذي يتأثر الخلايا بالأنسولين بشكل غير طبيعي
موانع إصدار مرض السكري: الوراثة والعوامل الجيوغرافية والعمر
الأعراض المشتركة للسكري النوع الأول والثاني: العطش المزمن والتبول المتكرر
فحوصات الدم المناسبة لتشخيص مرض السكري: اختبار A1C واختبار السكر في الدم عشوائيا واختبار السكر في الدم بعد الصيام
كيفية العيش مع مرض السكري: العلاج بالأنسولين والأعتدال في الحمية الغذائية وممارسة الرياضة بانتظام
مرض السكري: الأسباب والأعراض والعلاجات المختلفة
نوعان من مرض السكري: الفرق بين النوع الأول والنوع الثاني
كل ما يجب معرفته عن مرض السكري في العالم العربي
مرض السكري النوع الأول: شرح مفصل وطرق العلاج
مرض السكري النوع الثاني: كيف يمكن تحديد التشخيص والتعامل معه
مرض السكري للنساء الحوامل: الأعراض والمخاطر والعلاج
التفاح الحلو: أخطر الأطعمة على مرضى السكري وكيفية تجنبها
قائمة من الأطعمة المساعدة في تحسين صحة مرضى السكري
أفضل العلاجات الحديثة لمرضى السكري النوع الثاني
أعراض مرض السكري التي يجب على المرضى الانتباه إليها في حياتهم اليومية
